01111111111111111111111111111111
1P00000000000000000C110000000C11
11111111111111110C1111C001110011
100000000000000000000000001CCCC1
10011111111111111111111111111111
10000000000000000000000C000000E1
11111111111111111111111111111111