1111111111111111111111111111111111
1E00000000000000000000000000000001
10100101001000001010010000000101E1
1C10010010101010001001000000010101
1000000000000000000000000000000001
1P00000000000000000000000000000001
1000000000000000000000000000000001
1000000000000000000000000000000001
1000000000000000000001000000000001
1000000000000000000000000000000011
1000000000000000000000000000000001
1111111111111111111111111111111111