111111111111111
1E0000000000001
1000000C0000001
1000000000000P1
1E0000000000001
1000000C0000001
100000000000011
1E0000000000001
1000000C0000001
100000000000011
1E0000000000001
1000000C0000001
100000000000001
1E0000000000001
1000000C0000001
100000000000001
111111111111111